Scripted Text is a system which can help you in typing a message. If enabled, it will send a complete message or emoticons to active window whenever you typed a specified message.

This is the list of scripted text :

hahaha=HAHAHAHAHAHAHAHAHAHAHAHAHAHAHAHA
hihihi=HIHIHIHIHIHIHIHIHIHIHIHIHIHIHIHI
hehehe=HEHEHEHEHEHEHEHEHEHEHEHEHEHEHEHE
huhuhu=HUHUHUHUHUHUHUHUHUHUHUHUHUHUHUHU
hohoho=HOHOHOHOHOHOHOHOHOHOHOHOHOHOHOHO
haha=Hahahaha
hihi=Hihihihi
hehe=Hehehehe
huhu=Huhuhuhu
hoho=Hohohoho
lol=Laghing Out Loud
;)=;) (randomised emoticon)
;(=;( (randomised emoticon)
;|=;| (randomised emoticon)
:)=:) (randomised emoticon)
:(=:( (randomised emoticon)
:|=:| (randomised emoticon)
?=???? (randomised)
:o=:o (randomised emoticon)
:p=:p (randomised emoticon)
:d=:d (randomised emoticon)
:x=:x (randomised emoticon)
:\=:\ (randomised emoticon)
:/=:/ (randomised emoticon)
;o=;o (randomised emoticon)
;p=;p (randomised emoticon)
;d=;d (randomised emoticon)
;x=;x (randomised emoticon)
;\=;\ (randomised emoticon)
;/=;/ (randomised emoticon)
!=!!!! (randomised)
wb=Welcome Back
tyt=Take Your Time
np=No Problem
yw=You Welcome
brb=Be Right Back
bbl=Be Back Later
bbs=Be Back Soon
tc=Take Care
omg=Oh My God
ok=Ok
okay=Ok
k=Ok
yes=Yes
yup=Yup
yep=Yep
yupe=Yupe
no=No
nope=Nope
nop=Nop
ty=Thank You
gtg=Got To Go
asl=Age Sex Location
gts=Got To Sleep
jk=Just Kidding
j/k=Just Kidding
pls=Please
ic=I See
btw=By The Way
imho=In My Honest Opinion
ltns=Long Time No See
ltnc=Long Time No See
oic=Oh I See
thx=Thanks
tnx=Thanks
ctc=Care To Chat
wtf=What The Fuck
jic=Just In Case
wth=What The Hell
bye=Bye
nm=Nevermind
gtf=Get The Fuck
gth=Get The Hell
nvm=Nevermind
cool=Cool
kewl=Kewl
ttyl=Talk To You Later
bbiaf=Be Back In A Few
rofl=Rolling On Floor Laughing
rotfl=Rolling On The Floor Laughing
roflmao=Rolling On Floor Laughing My Ass Off
rotflmao=Rolling On The Floor Laughing My Ass Off
bs=Bull Shit
hs=Holly Shit
ys=You Suck
wd=Well Done
nw=No Way
cya=Cya
heh=Heh
afk=Away From Keyboard
fyi=For Your Information
lmao=Laughing My Ass Off